Level
{
	<Levelnumber>10;
	<Tipp>'There is nothing like teamwork!';
	<SizeX>14;
	<SizeY>10;
	<AmountOfBalls>3;
	
	<Balls>
		1;1;8;1;0
		0;8;1;2
		0;11;8;3
	</Balls>
	
	<Tiles>
		2;2;2;2;2;2;2;2;2;2;2;2;2;2
		2;1;0;0;2;0;0;0;0;2;0;0;0;2
		2;0;0;0;2;0;0;0;0;4,2;0;0;0;2
		2;0;0;0;2;0;0;0;0;2;0;0;0;2
		2;0;0;0;2;5,3;0;0;5,2;2;0;0;0;2
		2;4,0;2;2;2;2;4,3;2;2;2;2;4,1;2;2
		2;0;0;0;2;0;0;0;0;2;0;0;0;2
		2;0;0;0;2;0;0;0;0;2;0;0;0;2
		2;0;0;5,1;2;0;0;0;5,0;2;0;0;0;2
		2;2;2;2;2;2;2;2;2;2;2;2;2;2
	</Tiles>
}