Level
{
	<Levelnumber>8;
	<Tipp>'Hit space twice.';
	<SizeX>10;
	<SizeY>10;
	<AmountOfBalls>3;
	
	<Balls>
		1;1;6;1;3;2
		0;6;6;2
		4;1;8;3;0;2
	</Balls>
	
	<Tiles>
		2;2;2;2;2;2;2;2;2;2
		2;1;1;1;1;3;3;3;3;2
		2;1;1;1;1;3;3;3;3;2
		2;1;1;1;1;3;3;3;3;2
		2;1;1;1;1;3;3;0;3;2
		2;0;0;0;0;3;3;0;3;2
		2;0;0;0;0;3;0;0;3;2
		2;2;2;2;2;2;2;2;2;2
		2;0;0;0;0;0;0;0;3;2
		2;2;2;2;2;2;2;2;2;2
	</Tiles>
}