Level
{
	<Levelnumber>7;
	<Tipp>'Lets have some fun with that.';
	<SizeX>10;
	<SizeY>10;
	<AmountOfBalls>2;
	
	<Balls>
		
	</Balls>
	
	<Tiles>
		2;2;2;2;2;3;3;3;3;3
		2;2;2;2;2;3;0;0;0;3
		2;2;2;2;2;3;0;0;0;3
		2;1;0;0;0;3;0;0;0;3
		2;0;0;0;0;3;0;0;0;3
		2;0;0;0;0;3;0;0;0;3
		2;0;0;0;0;3;0;0;0;3
		2;3;3;0;0;3;0;3;3;3
		2;0;0;0;0;3;0;0;0;3
		2;2;2;2;2;3;3;3;3;3
	</Tiles>
}