Level
{
	<Levelnumber>13;
	<Tipp>'Do not worry, this is the end of the ride.';
	<SizeX>13;
	<SizeY>13;
	<AmountOfBalls>2;
	
	<Balls>
		1;9;3;1;2;3
		2;10;3;2;3
	</Balls>
	
	<Tiles>
		2;2;2;2;2;2;2;2;2;2;2;2;2
		2;1;3;2;0;6;6;6;4,1;0;0;5,3;3
		2;4,6;3;2;0;3;3;3;2;5,1;2;0;2
		2;6;3;2;0;0;0;0;2;0;0;5,2;2
		2;6;3;2;2;2;2;4,2;2;2;2;2;2
		2;6;4,5;6;6;6;2;0;2;2;3;2;2
		2;2;6;6;6;6;2;0;2;6;6;6;2
		2;3;3;3;3;6;2;0;2;6;6;6;2
		2;2;2;2;2;0;2;0;6;6;6;4,3;2
		2;5,6;5,1;0;2;0;2;2;2;6;2;2;2
		2;5,5;2;0;4,4;5,4;6;6;6;6;6;6;2
		2;5,3;0;5,2;2;0;2;6;6;6;6;6;2
		2;2;2;2;2;2;2;2;2;2;2;2;2
	</Tiles>
}