Level
{
	<Levelnumber>6;
	<Tipp>'Whats going on here?';
	<SizeX>10;
	<SizeY>10;
	<AmountOfBalls>2;
	
	<Balls>
		1;2;6;1;3;2
		0;7;6;2
	</Balls>
	
	<Tiles>
		2;2;2;2;2;3;3;3;3;3
		2;1;1;1;2;3;3;3;3;3
		2;1;1;1;2;3;3;3;3;3
		2;1;1;1;2;3;3;3;3;3
		2;0;0;0;2;3;3;3;3;3
		2;0;0;0;2;3;0;0;0;3
		2;0;0;0;2;3;0;0;0;3
		2;0;0;0;2;3;0;0;0;3
		2;0;0;0;2;3;0;0;0;3
		2;2;2;2;2;3;3;3;3;3
	</Tiles>
}