Level
{
	<Levelnumber>5;
	<Tipp>'You have to be either fast or clever.';
	<SizeX>10;
	<SizeY>10;
	<AmountOfBalls>2;
	
	<Balls>
		1;1;8;1;2;0
		0;1;3;2
	</Balls>
	
	<Tiles>
		2;2;2;2;2;2;2;2;2;2
		2;0;0;0;0;0;0;0;1;2
		2;0;0;0;0;0;0;0;0;2
		2;0;0;0;0;0;0;0;0;2
		2;0;0;0;0;0;0;0;0;2
		2;0;0;0;0;0;0;0;0;2
		2;2;2;2;2;2;2;2;2;2
		2;3;0;0;0;0;0;0;0;2
		2;0;0;0;0;0;0;0;3;2
		2;2;2;2;2;2;2;2;2;2
	</Tiles>
}