Level
{
	<Levelnumber>10;
	<Tipp>'There is nothing like teamwork!';
	<SizeX>14;
	<SizeY>10;
	<AmountOfBalls>2;
	
	<Balls>
		
	</Balls>
	
	<Tiles>
		2;2;2;2;2;2;2;2;2;2;2;2;2;2
		2;1;0;0;2;0;0;0;0;2;0;0;0;2
		2;0;0;0;2;0;0;0;0;5,3;0;0;0;2
		2;0;0;0;2;0;0;0;0;2;0;0;0;2
		2;0;0;0;2;4,4;0;0;4,3;2;0;0;0;2
		2;5,1;2;2;2;2;5,4;2;2;2;2;5,2;2;2
		2;0;0;0;2;0;0;0;0;2;0;0;0;2
		2;0;0;0;2;0;0;0;0;2;0;0;0;2
		2;0;0;4,2;2;0;0;0;4,1;2;0;0;0;2
		2;2;2;2;2;2;2;2;2;2;2;2;2;2
	</Tiles>
}