Level
{
	<Levelnumber>2;
	<Tipp>'Be careful...';
	<SizeX>10;
	<SizeY>10;
	<AmountOfBalls>1;
	
	<Balls>
		1;1;8;1;0
	</Balls>
	
	<Tiles>
		2;2;2;2;2;2;2;2;2;2
		2;1;0;0;0;0;0;0;0;2
		2;0;0;0;0;0;0;0;0;2
		2;0;0;0;0;0;0;0;0;2
		2;0;0;0;0;0;0;0;0;2
		2;0;0;0;0;0;0;0;0;2
		2;3;3;3;3;3;0;0;0;2
		2;0;0;0;0;0;0;0;0;2
		2;0;0;0;0;0;0;0;0;2
		2;2;2;2;2;2;2;2;2;2
	</Tiles>
}