Level
{
	<Levelnumber>12;
	<Tipp>'If you can't pass through the blue -- then who?';
	<SizeX>10;
	<SizeY>10;
	<AmountOfBalls>2;
	
	<Balls>
		1;7;7;1;0
		2;1;8;2;0
	</Balls>
	
	<Tiles>
		2;2;2;2;2;2;2;2;2;2
		2;0;0;0;0;6;0;0;1;2
		2;0;0;0;0;6;0;0;0;2
		2;0;0;0;0;6;0;0;0;2
		2;0;0;0;0;6;6;6;6;2
		2;0;0;0;0;6;0;0;0;2
		2;0;0;0;0;6;0;0;0;2
		2;0;0;0;0;6;0;0;0;2
		2;0;0;0;0;6;0;0;0;2
		2;2;2;2;2;2;2;2;2;2
	</Tiles>
}