Level
{
	<Levelnumber>9;
	<Tipp>'Impossible? Move over the yellow square.';
	<SizeX>10;
	<SizeY>10;
	<AmountOfBalls>2;
	
	<Balls>
		1;1;8;1;0
		0;3;8;2
	</Balls>
	
	<Tiles>
		2;2;2;2;2;2;2;2;2;2
		2;0;0;0;0;0;0;0;1;2
		2;0;0;0;0;0;0;0;0;2
		2;0;0;0;0;0;0;0;0;2
		2;0;0;0;0;0;0;0;0;2
		2;0;0;0;0;0;0;0;0;2
		2;4,1;2;2;2;2;2;2;2;2
		2;0;0;0;0;0;0;0;0;2
		2;0;0;0;5,1;0;0;0;0;2
		2;2;2;2;2;2;2;2;2;2
	</Tiles>
}