Level
{
	<Levelnumber>1;
	<Tipp>'Tipp Test';
	<SizeX>10;
	<SizeY>10;
	<AmountOfBalls>2;
	
	<Balls>
		0;1;1;1
		1;5;5;2;0
	</Balls>
	
	<Tiles>
		2;2;2;2;2;2;2;2;2;2
		2;0;0;0;0;0;0;0;0;2
		2;0;0;0;0;0;0;0;0;2
		2;0;0;0;0;0;0;0;0;2
		2;0;0;0;0;0;0;0;0;2
		2;0;0;0;0;0;0;0;0;2
		2;0;0;0;0;0;0;0;0;2
		2;0;0;0;0;0;0;0;0;2
		2;0;0;0;0;0;0;0;1;2
		2;2;2;2;2;2;2;2;2;2
	</Tiles>
}