Level
{
	<Levelnumber>11;
	<Tipp>'It is all about the timing.';
	<SizeX>10;
	<SizeY>10;
	<AmountOfBalls>2;
	
	<Balls>
		1;1;8;1;2;0
		0;8;8;2
	</Balls>
	
	<Tiles>
		2;2;2;2;2;2;2;2;2;2
		2;2;2;2;2;2;2;2;1;2
		2;2;2;2;2;2;2;2;0;2
		2;2;2;2;2;2;2;2;4,2;2
		2;2;2;2;2;2;2;2;0;2
		2;2;2;2;2;2;2;2;0;2
		2;0;0;5,2;5,2;0;3;2;4,1;2
		2;0;2;2;2;2;2;2;0;2
		2;0;0;5,1;5,1;0;3;2;0;2
		2;2;2;2;2;2;2;2;2;2
	</Tiles>
}