Level
{
	<Levelnumber>11;
	<Tipp>'It is all about the timing.';
	<SizeX>10;
	<SizeY>10;
	<AmountOfBalls>2;
	
	<Balls>
		
	</Balls>
	
	<Tiles>
		2;2;2;2;2;2;2;2;2;2
		2;2;2;2;2;2;2;2;1;2
		2;2;2;2;2;2;2;2;0;2
		2;2;2;2;2;2;2;2;5,3;2
		2;2;2;2;2;2;2;2;0;2
		2;2;2;2;2;2;2;2;0;2
		2;0;5,2;0;4,3;0;3;2;0;2
		2;5,1;2;2;2;2;2;2;0;2
		2;0;4,2;0;4,1;0;3;2;0;2
		2;2;2;2;2;2;2;2;2;2
	</Tiles>
}